A   A   A   A   A   A   A   A   A   A   A   A   A   A   A   A   A   A   A   S1  S2  S3  A   A   A   A   A   A   A   A   A   A   A   A   A   A   S1  S2  S2  S3  A   A   A   A   A   A   A   A   
A   A   A   A   A   A   A   A   S1  S2  S3  A   A   A   A   A   A   A   A   S6  S7  S8  A   A   A   A   A   S1  S2  S2  S2  S3  A   A   A   A   S6  S7  S7  S8  A   A   A   A   A   A   A   A   
A   A   A   A   A   A   A   A   S6  S7  S8  A   A   A   A   A   A   A   A   A   A   A   A   A   A   A   A   S6  S7  S7  S7  S8  A   A   A   A   A   A   A   A   A   A   A   A   A   A   A   A   
A   A   A   A   A   A   A   A   A   A   A   A   A   A   A   A   A   A   A   A   A   A   A   A   A   A   A   A   A   A   A   A   A   A   A   A   A   A   A   A   A   A   A   A   A   A   A   A   
A   A   A   A   A   A   A   A   A   A   A   A   A   A   A   A   A   A   A   A   A   A   A   A   A   A   A   A   A   A   A   A   A   A   A   A   A   A   A   A   A   A   A   A   A   A   A   A   
A   A   A   A   A   A   A   A   A   A   A   A   A   A   A   A   A   A   A   A   A   A   A   A   A   A   A   A   A   A   A   A   A   A   A   A   A   A   A   A   A   A   A   A   A   A   A   A   
A   A   A   A   A   A   A   A   A   A   A   A   A   A   A   A   A   A   A   A   A   A   A   A   A   A   A   A   A   A   A   A   A   A   A   A   A   A   A   A   A   A   A   A   A   A   A   A   
A   A   A   A   A   A   A   A   A   A   A   A   A   A   A   A   A   A   A   A   A   A   A   A   A   A   A   A   A   A   A   A   A   A   A   A   A   A   A   A   A   A   A   A   A   A   A   A   
A   A   A   A   A   A   A   A   A   A   A   A   A   A   A   A   A   A   A   A   A   A   A   A   A   A   A   A   A   A   A   A   A   A   A   A   A   A   A   A   A   A   A   A   A   A   A   A   
A   A   A   A   A   A   A   A   A   A   A   A   A   A   A   A   A   A   A   A   A   A   A   A   A   A   A   A   A   A   A   A   A   A   A   A   A   A   A   A   A   A   A   A   A   A   A   A   
A   A   P20 A   A   A   A   A   A   A   A   A   A   A   A   A   A   A   A   A   A   A   A   A   A   A   A   A   A   A   A   A   A   A   A   A   A   A   A   A   A   A   A   A   A   A   A   A   
A   P25 P26 P29 A   A   A   A   A   A   A   A   A   A   A   A   A   P20 A   A   A   A   A   A   A   A   A   A   A   A   A   A   A   A   A   A   A   A   A   A   A   A   A   A   A   A   A   A   
P25 P26 P27 P28 P29 A   A   A   A   A   A   P10 P11 P11 P11 P12 P25 P26 P29 A   A   A   A   P10 P11 P12 A   A   A   A   A   A   A   A   A   A   A   A   A   A   A   P10 P11 P11 P12 A   A   A 
G1  G1  G1  G1  G1  G1  G1  G1  G1  G1  G1  G1  G1  G1  G1  G1  G1  G1  G1  G1  G1  G1  G1  G1  G1  G1  G1  G1  G1  G1  G1  G1  G1  G1  G1  G1  G1  G1  G1  G1  G1  G1  G1  G1  G1  G1  G1  G1  
G1  G1  G1  G1  G1  G1  G1  G1  G1  G1  G1  G1  G1  G1  G1  G1  G1  G1  G1  G1  G1  G1  G1  G1  G1  G1  G1  G1  G1  G1  G1  G1  G1  G1  G1  G1  G1  G1  G1  G1  G1  G1  G1  G1  G1  G1  G1  G1